DM : Direct Message (Mensagem Direta)
RT : Retweet (Retuitar)
MT : Modified Tweet (Tweet Modificado)
HT : Hashtag (Hashtag)
TL;DR : Too Long; Didn't Read (Muito Longo; Não Li)
ICYMI : In Case You Missed It (Caso Tenha Perdido)
FOMO : Fear Of Missing Out (Medo de Perder Algo)
IMO : In My Opinion (Na Minha Opinião)
IMHO : In My Humble Opinion (Na Minha Humilde Opinião)
BTW : By The Way (A Propósito)
NSFW : Not Safe For Work (Não Seguro Para o Trabalho)
BRB : Be Right Back (Volto Já)
TBT : Throwback Thursday (Quinta-feira do Retorno ao Passado)
YOLO : You Only Live Once (Você Só Vive Uma Vez)
OMG : Oh My God (Oh Meu Deus)
AFAIK : As Far As I Know (Até Onde Sei)
DMs are open : Direct Messages are open (Mensagens Diretas estão abertas)
SMH : Shaking My Head (Balançando a Cabeça)
LOL : Laugh Out Loud (Rindo Alto)
ICYDK : In Case You Didn't Know (Caso Você Não Saiba)
FF : Follow Friday (Sexta-feira de Indicações)
FTW : For The Win (Para a Vitória)
HTH : Hope This Helps (Espero Que Isso Ajude)
U : You (Você)
AMA : Ask Me Anything (Pergunte-me Qualquer Coisa)
B4 : Before (Antes)
BF : Best Friends (Melhores Amigos)
BFF : Best Friends Forever (Melhores Amigos para Sempre)
BTS : Behind The Scenes (Nos Bastidores)
GG : Good Game (Bom Jogo)
GR8 : Great (Ótimo)
IDC : I Don't Care (Eu Não Me Importo)
IRL : In Real Life (Na Vida Real)
JK : Just Kidding (Brincadeira)
LMAO : Laughing My Ass Off (Rindo Muito)
LMK : Let Me Know (Me Avise)
OOTD : Outfit Of The Day (Look do Dia)
PLZ : Please (Por Favor)
TTYL : Talk To You Later (Falo Contigo Mais Tarde)
TL : Timeline (Linha do Tempo)
TBH: To Be Honest (Para Ser Honesto)
FR: For Real (A Sério)
ASAP : As Soon As Possible (Assim que Possível)